county_fips,block_group,CVAP_estimate,CVAP_margin_of_error,reg_count,reg_potential,percent_reg
04013,040133198006,565,191,642,-77,1.1362831858407079
04013,040134223013,800,281,874,-74,1.0925
04013,040133194032,810,174,876,-66,1.0814814814814815
04013,040134220022,385,155,388,-3,1.0077922077922077
04013,040133198003,360,163,354,6,0.9833333333333333
04013,040133192013,390,224,379,11,0.9717948717948718
04013,040131162023,420,168,399,21,0.95
04013,040134221022,830,243,799,31,0.9626506024096385
04013,040134216022,430,184,383,47,0.8906976744186047
04013,040131162024,535,201,474,61,0.8859813084112149
04013,040133189004,825,308,759,66,0.92
04013,040134213024,330,194,242,88,0.7333333333333333
04013,040134215012,485,111,396,89,0.8164948453608247
04013,040134218023,500,129,408,92,0.816
04013,040134213032,905,218,806,99,0.8906077348066298
04013,040131162043,385,178,279,106,0.7246753246753247
04013,040134219023,475,140,366,109,0.7705263157894737
04013,040133194015,550,259,439,111,0.7981818181818182
04013,040134214003,420,125,309,111,0.7357142857142858
04013,040134219021,450,193,338,112,0.7511111111111111
04013,040133197053,480,160,365,115,0.7604166666666666
04013,040134214002,345,179,228,117,0.6608695652173913
04013,040134214001,385,118,268,117,0.6961038961038961
04013,040134221043,585,182,458,127,0.7829059829059829
04013,040134215022,650,199,514,136,0.7907692307692308
04013,040134213023,255,164,118,137,0.4627450980392157
04013,040134221044,510,155,372,138,0.7294117647058823
04013,040134212013,465,201,321,144,0.6903225806451613
04013,040133184002,1075,305,925,150,0.8604651162790697
04013,040133191032,505,155,337,168,0.6673267326732674
04013,040133184003,615,300,447,168,0.7268292682926829
04013,040134212021,960,201,788,172,0.8208333333333333
04013,040133190003,450,149,277,173,0.6155555555555555
04013,040133185013,520,168,345,175,0.6634615384615384
04013,040131162052,730,200,535,195,0.7328767123287672
04013,040133188003,835,284,638,197,0.7640718562874251
04013,040134219024,565,198,352,213,0.6230088495575221
04013,040133191044,375,258,157,218,0.4186666666666667
04013,040133191043,535,274,313,222,0.5850467289719626
04013,040131162021,900,257,672,228,0.7466666666666667
04013,040134216012,770,175,536,234,0.6961038961038961
04013,040134221041,440,159,199,241,0.45227272727272727
04013,040133195002,950,383,701,249,0.7378947368421053
04013,040133198002,430,251,180,250,0.4186046511627907
04013,040134213031,1030,187,779,251,0.7563106796116504
04013,040134221021,715,248,460,255,0.6433566433566433
04013,040133197051,1060,205,791,269,0.7462264150943396
04013,040131162022,885,199,613,272,0.6926553672316385
04013,040133197032,670,152,393,277,0.5865671641791045
04013,040134221032,920,200,635,285,0.6902173913043478
04013,040134216011,980,202,687,293,0.7010204081632653
04013,040133196001,1030,318,735,295,0.7135922330097088
04013,040134219012,850,220,551,299,0.648235294117647
04013,040134215013,780,241,478,302,0.6128205128205129
04013,040133194033,835,250,526,309,0.629940119760479
04013,040134218011,695,228,379,316,0.5453237410071943
04013,040134221072,815,222,494,321,0.6061349693251534
04013,040133197052,795,178,472,323,0.5937106918238994
04013,040139413004,1555,343,1231,324,0.7916398713826367
04013,040134218012,1045,243,709,336,0.6784688995215311
04013,040133198005,1000,285,662,338,0.662
04013,040134221063,680,198,341,339,0.5014705882352941
04013,040134222032,520,190,176,344,0.3384615384615385
04013,040134216023,645,283,297,348,0.4604651162790698
04013,040133195003,730,319,378,352,0.5178082191780822
04013,040134215011,580,125,228,352,0.3931034482758621
04013,040134220011,975,272,613,362,0.6287179487179487
04013,040133194034,850,240,484,366,0.5694117647058824
04013,040134220012,790,263,423,367,0.5354430379746835
04013,040133197061,655,230,283,372,0.43206106870229005
04013,040134223012,1090,275,703,387,0.6449541284403669
04013,040133192014,970,362,582,388,0.6
04013,040134219022,765,212,375,390,0.49019607843137253
04013,040134214004,805,144,411,394,0.5105590062111801
04013,040134219011,1125,237,730,395,0.6488888888888888
04013,040134213033,965,225,565,400,0.5854922279792746
04013,040139413002,890,272,484,406,0.5438202247191011
04013,040131162042,865,403,458,407,0.5294797687861271
04013,040134220023,790,191,374,416,0.47341772151898737
04013,040133191012,640,170,219,421,0.3421875
04013,040134213041,845,226,414,431,0.48994082840236686
04013,040139413001,1260,328,819,441,0.65
04013,040133195001,1365,363,914,451,0.6695970695970695
04013,040133196002,1175,287,716,459,0.6093617021276596
04013,040134221051,1095,218,633,462,0.5780821917808219
04013,040134218021,725,299,262,463,0.36137931034482756
04013,040134223011,1050,349,579,471,0.5514285714285714
04013,040133191031,930,321,458,472,0.4924731182795699
04013,040133197041,1185,147,700,485,0.5907172995780591
04013,040133201001,1120,269,634,486,0.5660714285714286
04013,040134215021,1115,277,628,487,0.5632286995515695
04013,040134218022,1415,260,917,498,0.6480565371024735
04013,040134221052,1200,380,701,499,0.5841666666666666
04013,040134220021,940,223,438,502,0.46595744680851064
04013,040134213042,1115,251,613,502,0.5497757847533632
04013,040134221042,960,366,451,509,0.46979166666666666
04013,040133189003,1300,359,789,511,0.6069230769230769
04013,040133190002,945,226,429,516,0.45396825396825397
04013,040133185012,925,197,395,530,0.42702702702702705
04013,040133194041,1480,218,945,535,0.6385135135135135
04013,040134221033,920,222,363,557,0.39456521739130435
04013,040133194031,1085,299,525,560,0.4838709677419355
04013,040133192021,1005,238,431,574,0.42885572139303485
04013,040133191033,945,310,365,580,0.3862433862433862
04013,040134212022,1215,289,634,581,0.5218106995884774
04013,040133197062,900,287,317,583,0.3522222222222222
04013,040134221045,1260,429,672,588,0.5333333333333333
04013,040133185011,1495,257,906,589,0.6060200668896321
04013,040133196004,1320,333,730,590,0.553030303030303
04013,040133194013,1350,477,740,610,0.5481481481481482
04013,040134213022,1490,405,874,616,0.5865771812080537
04013,040133197033,1310,333,690,620,0.5267175572519084
04013,040133198001,1195,503,565,630,0.47280334728033474
04013,040133192011,1080,379,449,631,0.41574074074074074
04013,040133195004,1745,367,1114,631,0.6383954154727793
04013,040133189002,1445,378,798,647,0.5522491349480969
04013,040133184001,1375,423,715,660,0.52
04013,040134216021,1065,299,404,661,0.37934272300469485
04013,040133197031,1505,284,829,676,0.5508305647840531
04013,040133187002,1040,261,339,701,0.32596153846153847
04013,040133194014,1140,313,430,710,0.37719298245614036
04013,040131162051,735,142,7,728,0.009523809523809525
04013,040133201002,1535,227,791,744,0.5153094462540717
04013,040133194012,1595,471,848,747,0.5316614420062696
04013,040134221061,1570,225,812,758,0.5171974522292994
04013,040134221023,1240,326,471,769,0.37983870967741934
04013,040133196003,1540,375,757,783,0.4915584415584416
04013,040133188002,1380,403,566,814,0.4101449275362319
04013,040133192012,1380,438,542,838,0.3927536231884058
04013,040134221062,1260,251,418,842,0.33174603174603173
04013,040134212012,1810,280,936,874,0.5171270718232044
04013,040134221031,1465,349,585,880,0.3993174061433447
04013,040133193001,1910,312,1015,895,0.5314136125654451
04013,040133188001,1295,287,392,903,0.3027027027027027
04013,040133188004,1620,437,716,904,0.4419753086419753
04013,040134213021,1575,511,654,921,0.41523809523809524
04013,040130101021,945,386,2,943,0.0021164021164021165
04013,040133197063,1805,303,830,975,0.4598337950138504
04013,040133192022,1540,282,562,978,0.36493506493506495
04013,040134221071,2005,321,956,1049,0.4768079800498753
04013,040134222031,2190,263,1129,1061,0.5155251141552512
04013,040139413003,1820,318,743,1077,0.40824175824175823
04013,040133191042,1645,424,541,1104,0.32887537993920973
04013,040133189001,2055,611,948,1107,0.46131386861313867
04013,040133198004,1560,405,444,1116,0.2846153846153846
04013,040134212011,1595,421,456,1139,0.2858934169278997
04013,040133191011,1440,295,288,1152,0.2
04013,040133191041,1570,509,405,1165,0.25796178343949044
04013,040133187001,1900,612,698,1202,0.36736842105263157
04013,040131162053,1370,279,2,1368,0.00145985401459854
04013,040132168163,1745,466,1,1744,0.0005730659025787965
04013,040133190001,2435,1320,453,1982,0.18603696098562628
04013,040132177001,2100,341,1,2099,0.0004761904761904762
04013,040133190004,4140,622,250,3890,0.06038647342995169
